111111111
10EC11111
110100011
100C00111
11110P001
111111111
