111111111
10C1111E1
110100011
100C00111
11110P001
111111111
