111111111
10EC11111
110100011
100C00111
1111011P1
111111111
